NO src/xpm/t2.xpm
SO src/xpm/t4.xpm
WE src/xpm/t2.xpm
EA src/xpm/t4.xpm

F 60,200,19
C 255,200,100

11111111111
10000000001
10000000001
10000100001
10000000001
10000000001
10000000001
10000000001
10000000001
10000000001
10000000001
10000000001
100000000011111111111
100000000010000000001
100000000000000000001
100000000011111111111
10000000001
10000N00001
11111111111

map[(pos_y - 1 / 64) + 1][pos_x / 64] != '1'