NO src/xpm/t4.xpm
SO src/xpm/t4.xpm
WE src/xpm/t4.xpm
EA src/xpm/t4.xpm

F 60,200,19
C 255,200,100

        1111111111111111111111111
        1000000000110000000000001
        1011000001110000000000001
        100100000000000000N000001
111111111011000001110000000000001
100000000011000001110111100011111
11110111111111011100000010001
11110111111111011101010010001
11000000110101011100010010001
10000000000100001100101010001
10000000000000001101010010001
11000001110101011111011110001
11110111 1110101 101111010001
11111111 1111111 111111111111
