NO src/xpm/t4.xpm
SO src/xpm/t4.xpm
WE src/xpm/t4.xpm
EA src/xpm/t4.xpm

F 60,200,19
C 255,200,100

11111111111
10000000001
10000000001
10000000001
10000N00001
10000000001
10000000001
10000000001
11111111111